ปลาดิบ	ญี่ปุ่น
ซามูไร	ญี่ปุ่น
นินจา	ญี่ปุ่น
อาทิตย์อุทัย	ญี่ปุ่น
มังกร	จีน
กิมจิ	เกาหลี
โสมแดง	เกาหลีเหนือ
โสมขาว	เกาหลีใต้
ผู้ดี	อังกฤษ
ไก่งวง	ตุรกี
จิงโจ้	ออสเตรเลีย
กีวี	นิวซีแลนด์
อิเหนา	อินโดนีเซีย
ลอดช่อง	สิงคโปร์
เมอร์ไลออน	สิงคโปร์
มะกะโรนี	อิตาลี
น้ำหอม	ฝรั่งเศส
กระทิง	สเปน
หมีขาว	รัสเซีย
นครวัด	กัมพูชา
ฝอยทอง	โปรตุเกส
กังหันลม	เนเธอร์แลนด์
เจงกิสข่าน	มองโกเลีย